Aest ,rid  ,     
Al   ,ad   ,a    
Al   ,eit  ,a    
Al   ,et   ,a    
Al   ,sa   ,     
Al   ,sa   ,dis  
Ar   ,ma   ,     
Ar   ,no   ,ra   
As   ,dis  ,     
As   ,gerd ,     
As   ,gerd ,     
Ash  ,ild  ,     
Ast  ,a    ,     
Ast  ,ri   ,     
Ast  ,rid  ,     
Ast  ,rid  ,     
Aud  ,     ,     
Ber  ,a    ,     
Ber  ,jot  ,     
Ber  ,thor ,a    
Bol  ,la   ,     
Dal  ,la   ,     
Dot  ,ta   ,     
Drap ,la   ,     
Dri  ,fa   ,     
Fast ,vi   ,     
Frey ,gerd ,     
Gae  ,la   ,     
Geir ,ild  ,     
Geir ,ny   ,     
Ger  ,id   ,     
Gja  ,fa   ,     
Grei ,land ,     
Grel ,a    ,     
Gris ,a    ,     
Gud  ,la   ,     
Gud  ,ney  ,     
Gud  ,ny   ,     
Gud  ,rid  ,     
Gud  ,run  ,     
Gun  ,hild ,     
Hall ,a    ,     
Hall ,ber  ,a    
Hall ,dis  ,     
Hall ,gerd ,     
Hall ,kat  ,la   
Hall ,veig ,     
He   ,din  ,ald  
Kat  ,ja   ,     
Heith,     ,     
Hell ,ga   ,     
Her  ,dis  ,     
Her  ,kja  ,     
Hild ,     ,     
Hild ,ig   ,un   
Gis  ,frid ,     
Holm ,la   ,     
Href ,na   ,     
Hrod ,ny   ,     
Hun  ,gerd ,     
In   ,ga   ,     
In   ,ga   ,gard 
In   ,gel  ,tor  
In   ,gi   ,bjorg
In   ,gi   ,gerd 
In   ,gi   ,run  
In   ,gi   ,tyr  
Ing  ,rid  ,     
Ing  ,ul   ,frid 
Ing  ,un   ,     
Jarn ,ger  ,     
Jo   ,frid ,     
Jo   ,runn ,     
Kad  ,lin  ,     
Mart ,kja  ,     
Ma   ,til  ,da   
Mel  ,kor  ,ka   
Nid  ,biorg,     
Od   ,bjorg,     
Od   ,ny   ,     
Osk  ,     ,     
Ra   ,fat  ,a    
Rag  ,hild ,     
Rag  ,n    ,frid 
Ran  ,veig ,     
Ru   ,na   ,     
Saen ,     ,     
Sa   ,ga   ,     
Sal  ,berg ,     
Sal  ,bjorg,     
Sal  ,veig ,     
Sib  ,be   ,     
Sig  ,ny   ,     
Sig  ,rid  ,     
Skald,     ,     
Skur ,     ,     
Stein,vor  ,     
Styr ,la   ,     
Sval ,a    ,     
Tar  ,gard ,     
The  ,kat  ,la   
Thjod,hild ,     
Thor ,hild ,     
Thu  ,rid  ,     
Thy  ,re   ,     
To   ,fa   ,     
Ton  ,na   ,     
Tyr  ,a    ,     
Tyr  ,bjorg,     
Tyr  ,dis  ,     
Tyr  ,fin  ,na   
Tyr  ,frid ,     
Tyr  ,gaerd,     
Tyr  ,gerd ,     
Tyr  ,grim ,a    
Tyr  ,gun  ,na   
Tyr  ,hal  ,la   
Tyr  ,laug ,     
Tyr  ,unn  ,     
Val  ,gerd ,     
Vig  ,dis  ,     
Yng  ,vild ,     
Yrs  ,a